{
	"name": "Field",
	"background": "Images/background.png",
	"foreground": "Images/foreground.png",
	"gravity": "-9.81",
	"sizeRatio": "0.104166667",
	"ground": [
		[814,609,668,772,668,1080,1264,1080,1264,772,1123,609,814,609],
		[1296,792,1264,772,1264,1080,1299,1080],
		[1428,745,1482,750,1557,864,1557,1080,1299,1080,1296,792,1364,751],
		[1617,876,1557,864,1557,1080,1617,1080],
		[1680,854,1617,876,1617,1080,1680,1080],
		[1920,1080,1920,732,1894,720,1815,732,1741,773,1680,854,1680,1080],
		[636,790,668,772,668,1080,636,1080],
		[636,790,636,1080,378,1080,378,864,453,750,507,745,571,751],
		[318,876,378,864,378,1080,318,1080],
		[255,854,318,876,318,1080,255,1080],
		[0,1080,0,732,41,720,120,732,194,773,255,854,255,1080]
	]
}